6
1 3 0 0 0 0
0 0 5 0 6 0
0 0 0 0 2 0
0 0 6 0 0 0
0 0 5 2 3 0
0 0 0 0 0 1
