6
5 0 0 0 0 0
6 1 2 0 3 0
0 0 0 0 0 0
0 0 2 5 0 0
0 0 0 0 1 0
0 0 0 6 3 0