6
0 0 2 0 0 0
0 6 5 0 3 0
0 0 0 0 0 0
0 0 5 0 3 0
0 0 6 1 2 0
0 0 0 0 0 1