6
0 0 0 0 6 3
0 1 0 0 1 0
0 0 0 0 0 0
0 0 0 0 0 5
0 0 0 0 0 2
6 3 5 0 0 2