6
3 0 0 0 0 2
0 0 0 0 0 1
0 0 0 5 6 3
0 0 0 0 0 0
0 2 1 5 6 0
0 0 0 0 0 0