6
5 0 0 0 0 0
0 1 6 2 0 0
0 3 0 6 0 5
0 0 0 0 0 2
1 0 0 0 0 0
3 0 0 0 0 0