6
0 0 0 0 0 0
3 1 0 0 0 3
5 6 6 2 0 2
0 0 0 0 0 0
0 0 0 0 1 0
0 0 5 0 0 0