5
1 2 0 0 0
0 0 6 0 2
3 0 1 0 0
0 5 0 0 0
0 0 3 5 6