5
0 0 0 2 5
0 2 6 0 0
0 0 0 0 0
6 1 0 0 5
3 0 3 0 1