5
1 0 6 0 3
0 0 2 0 5
0 0 0 0 0
0 6 0 3 0
0 1 2 5 0