5
0 1 6 5 0
0 0 0 2 0
0 0 2 0 0
1 0 0 3 0
6 0 3 5 0