5
0 0 0 1 6
1 0 0 0 0
0 0 2 0 0
0 0 0 3 0
6 3 2 0 0