5
1 3 0 0 0
0 0 0 0 0
6 0 6 1 0
5 0 0 5 0
3 0 0 0 0