5
0 0 0 0 1
1 3 0 0 5
0 0 0 6 2
0 5 0 0 0
3 6 0 0 2