5
1 3 5 0 0
0 0 0 3 0
0 0 0 1 5
6 2 0 0 0
0 0 0 6 2