7
1 3 0 0 0 0 0
0 0 0 0 0 1 0
5 3 0 0 0 0 0
0 0 5 0 0 0 6
0 0 6 0 0 0 0
0 0 0 2 4 2 0
0 0 0 0 0 0 4