7
3 2 0 0 0 0 2
0 1 0 0 0 4 6
0 0 0 0 0 4 0
0 0 0 0 0 0 0
0 0 6 5 0 0 0
0 0 0 0 0 1 0
0 2 5 0 0 0 0