7
1 5 0 0 0 0 6
0 0 0 2 4 3 0
0 0 0 0 0 0 0
0 0 6 0 0 0 0
0 0 0 0 0 4 0
0 0 1 5 0 2 0
3 0 0 0 0 0 0